10 10
*
..........
..........
...*..*...
...****...
..*....*..
..*.**.*..
..*....*..
...****...
..........
..........